area_id	area_name
wilson-camp-access	Wilson Camp Access
coffman-beach-access	Coffman Beach Access
boeckman-bridge-access	Boeckman Bridge Access
osage-beach-city-park-lake	Osage Beach City Park Lake
jaycee-park-lake-cole-county	Jaycee Park Lake (Cole County)
pikes-camp-access	Pikes Camp Access
proctor-park-lake-california	Proctor Park Lake (California)
binder-community-lake	Binder Community Lake
gravois-mills-access	Gravois Mills Access
shawnee-bend-access	Shawnee Bend Access
hough-park-lake-jefferson-city	Hough Park Lake (Jefferson City)
roger-v-viola-wachal-smith-conservation-area	Roger V. and Viola Wachal Smith Conservation Area
mckay-park-lake-jefferson-city	McKay Park Lake (Jefferson City)
runge-conservation-nature-center	Runge Conservation Nature Center
alice-ahart-mansfield-conservation-area	Alice Ahart Mansfield Conservation Area
conservation-commission-headquarters	Conservation Commission Headquarters
painted-rock-conservation-area	Painted Rock Conservation Area
brays-access	Brays Access
hite-prairie-conservation-area	Hite Prairie Conservation Area
church-farm-conservation-area	Church Farm Conservation Area
carl-r-noren-access-jefferson-city	Carl R. Noren Access (Jefferson City)
manito-lake-conservation-area	Manito Lake Conservation Area
marion-access	Marion Access
moreau-50-access	Moreau 50 Access
madden-ford-access	Madden Ford Access
capitol-view-access	Capitol View Access
proctor-towersite	Proctor Towersite
hartsburg-access	Hartsburg Access
hart-creek-conservation-area	Hart Creek Conservation Area
taos-countryside-park-lake	Taos Countryside Park Lake
marion-bottoms-conservation-area	Marion Bottoms Conservation Area
tipton-park-lake	Tipton Park Lake
toronto-springs-conservation-area	Toronto Springs Conservation Area
rinquelin-trail-lake-conservation-area	Rinquelin Trail Lake Conservation Area
mari-osa-access	Mari-Osa Access
dr-bernard-bruns-access	Dr. Bernard Bruns Access
smoky-waters-conservation-area	Smoky Waters Conservation Area
camdenton-conservation-service-center	Camdenton Conservation Service Center
prairie-home-conservation-area	Prairie Home Conservation Area
freeburg-towersite	Freeburg Towersite
wigwam-school-access	Wigwam School Access
bonnots-mill-access	Bonnots Mill Access
larry-r-gale-access	Larry R. Gale Access
plowboy-bend-conservation-area	Plowboy Bend Conservation Area
ashland-lake-university-missouri	Ashland Lake (University of Missouri)
brown-bend-access	Brown Bend Access
earthquake-hollow-conservation-area	Earthquake Hollow Conservation Area
fiery-fork-conservation-area	Fiery Fork Conservation Area
providence-access	Providence Access
carpenter-memorial-conservation-area	Carpenter Memorial Conservation Area
big-buffalo-creek-conservation-area	Big Buffalo Creek Conservation Area
schlicht-springs-access	Schlicht Springs Access
mount-hulda-towersite	Mount Hulda Towersite
three-creeks-conservation-area	Three Creeks Conservation Area
burnt-mill-cave-conservation-area	Burnt Mill Cave Conservation Area
rollins-ferry-access	Rollins Ferry Access
lamine-river-conservation-area	Lamine River Conservation Area
clifty-creek-conservation-area	Clifty Creek Conservation Area
clifty-creek-natural-area	Clifty Creek Natural Area
eagle-bluffs-conservation-area	Eagle Bluffs Conservation Area
riddle-bridge-access	Riddle Bridge Access
paydown-access	Paydown Access
central-regional-office	Central Regional Office
mokane-access	Mokane Access
bell-chute-access	Bell Chute Access
cosmo-bethel-lake-columbia	Cosmo-Bethel Lake (Columbia)
perry-philips-park-lake-columbia	A. Perry Philips Park Lake (Columbia)
kahrs-boger-park	Kahrs-Boger Park
nifong-park-pond-columbia	Nifong Park Pond (Columbia)
hinkson-woods-conservation-area	Hinkson Woods Conservation Area
twin-lakes-columbia	Twin Lakes (Columbia)
mary-lawson-conservation-area	Mary Lawson Conservation Area
spring-creek-gap-conservation-area	Spring Creek Gap Conservation Area
roubidoux-creek-conservation-area	Roubidoux Creek Conservation Area
gasconade-hills-conservation-area	Gasconade Hills Conservation Area
henry-jackson-waters-c-b-moss-memorial-wildlife-area	Henry Jackson Waters and C. B. Moss Memorial Wildlife Area
pointers-creek-access	Pointers Creek Access
mitschele-access	Mitschele Access
taylors-landing-access	Taylors Landing Access
waynesville-laughlin-roubidoux-parks	Waynesville (Laughlin-Roubidoux Parks)
ben-branch-lake-conservation-area	Ben Branch Lake Conservation Area
brickley-hollow-conservation-area	Brickley Hollow Conservation Area
columbia-vineyards-park-lake	Columbia (Vineyards Park Lake)
edmonson-access	Edmonson Access
stephens-park-lake-columbia	Stephens Park Lake (Columbia)
mora-conservation-area	Mora Conservation Area
jerome-access	Jerome Access
hi-lonesome-prairie-conservation-area	Hi Lonesome Prairie Conservation Area
little-dixie-lake-conservation-area	Little Dixie Lake Conservation Area
antimi-lake-columbia	Antimi Lake (Columbia)
hazelgreen-access	Hazelgreen Access
fort-leonard-wood-towersite	Fort Leonard Wood Towersite
mule-shoe-conservation-area	Mule Shoe Conservation Area
branch-towersite	Branch Towersite
lake-woods-columbia	Lake of the Woods (Columbia)
spring-fork-lake-sedalia-water-department	Spring Fork Lake (Sedalia Water Department)
truman-lake-fulton	Truman Lake (Fulton)
swinging-bridge-access	Swinging Bridge Access
chamois-access	Chamois Access
diana-bend-conservation-area	Diana Bend Conservation Area
hams-prairie-access	Hams Prairie Access
prosperine-access	Prosperine Access
bear-creek-conservation-area	Bear Creek Conservation Area
cooper-hill-conservation-area	Cooper Hill Conservation Area
paint-brush-prairie-conservation-area	Paint Brush Prairie Conservation Area
veterans-park-lake-fulton	Veterans Park Lake (Fulton)
morningside-lake-fulton	Morningside Lake (Fulton)
de-bourgmont-access	De Bourgmont Access
ionia-ridge-conservation-area	Ionia Ridge Conservation Area
barclay-conservation-area	Barclay Conservation Area
lead-mine-conservation-area	Lead Mine Conservation Area
coffin-cave-conservation-area	Coffin Cave Conservation Area
drovers-prairie-conservation-area	Drovers Prairie Conservation Area
columbia-norma-sutherland-smith-park-lake	Columbia (Norma Sutherland Smith Park Lake)
franklin-island-conservation-area	Franklin Island Conservation Area
hull-ford-access	Hull Ford Access
grandfather-prairie-conservation-area	Grandfather Prairie Conservation Area
bohigian-conservation-area	Bohigian Conservation Area
friendly-prairie-conservation-area	Friendly Prairie Conservation Area
gasconade-district-headquarters	Gasconade District Headquarters
davisdale-conservation-area	Davisdale Conservation Area
harriman-hill-access	Harriman Hill Access
marguerite-bray-conservation-area	Marguerite Bray Conservation Area
roberts-bluff-access	Roberts Bluff Access
reform-conservation-area	Reform Conservation Area
liberty-park-pond-sedalia	Liberty Park Pond (Sedalia)
lost-valley-fish-hatchery	Lost Valley Fish Hatchery
canaan-conservation-area	Canaan Conservation Area
schuman-park-lake-rolla	Schuman Park Lake (Rolla)
grannys-acres-conservation-area	Granny&#039;s Acres Conservation Area
bennett-spring-access	Bennett Spring Access
ber-juan-lake-rolla	Ber Juan Lake (Rolla)
pinhook-access	Pinhook Access
fredericksburg-ferry-access	Fredericksburg Ferry Access
tate-island-conservation-area	Tate Island Conservation Area
helds-island-access	Helds Island Access
davis-ford-access	Davis Ford Access
bennett-spring-fish-hatchery	Bennett Spring Fish Hatchery
clover-dell-park-lake-sedalia	Clover Dell Park Lake (Sedalia)
rocky-fork-lakes-conservation-area	Rocky Fork Lakes Conservation Area
little-prairie-conservation-area	Little Prairie Conservation Area
moniteau-creek-conservation-area	Moniteau Creek Conservation Area
mccredie-farm-lake-university-missouri	McCredie Farm Lake (University of Missouri)
beaver-creek-conservation-area	Beaver Creek Conservation Area
coleman-memorial-conservation-area	Coleman Memorial Conservation Area
lebanon-forestry-office	Lebanon Forestry Office
blackwater-bridge-access	Blackwater Bridge Access
drynob-access	Drynob Access
truman-reservoir-management-lands-little-tebo-creek	Truman Reservoir Management Lands (Little Tebo Creek)
moon-valley-access	Moon Valley Access
truman-reservoir-management-lands-cross-timbers	Truman Reservoir Management Lands (Cross Timbers)
anna-m-adams-access	Anna M. Adams Access
grand-bluffs-conservation-area	Grand Bluffs Conservation Area
moores-mill-access	Moores Mill Access
mint-spring-conservation-area	Mint Spring Conservation Area
mint-spring-access	Mint Spring Access
cross-timbers-access	Cross Timbers Access
williams-ford-access	Williams Ford Access
alfred-newton-gossett-conservation-area	Alfred Newton Gossett Conservation Area
scioto-lake-st-james	Scioto Lake (St. James)
ross-access	Ross Access
long-ford-access	Long Ford Access
gasconade-park-access	Gasconade Park Access
hermitage-access	Hermitage Access
lick-creek-conservation-area	Lick Creek Conservation Area
fayette-ricketts-lake	Fayette (Ricketts Lake)
ryden-cave-conservation-area	Ryden Cave Conservation Area
j-n-turkey-kearn-memorial-wildlife-area	J. N. Turkey Kearn Memorial Wildlife Area
d-c-rogers-lake-fayette	D. C. Rogers Lake (Fayette)
truman-reservoir-management-lands-brush-creek	Truman Reservoir Management Lands (Brush Creek)
osage-fork-conservation-area	Osage Fork Conservation Area
brysons-hope-conservation-area	Bryson&#039;s Hope Conservation Area
w-r-kearn-memorial-conservation-area	W. R. Kearn Memorial Conservation Area
bruns-tract	Bruns Tract
peters-lake-fayette	Peters Lake (Fayette)
truman-reservoir-management-lands-leesville	Truman Reservoir Management Lands (Leesville)
farrington-park-lake-windsor	Farrington Park Lake (Windsor)
whetstone-creek-conservation-area	Whetstone Creek Conservation Area
marshall-junction-conservation-area	Marshall Junction Conservation Area
r-f-clement-memorial-forest-wildlife-area	R. F. Clement Memorial Forest and Wildlife Area
john-f-murphy-memorial-state-forest-wildlife-area	John F. Murphy Memorial State Forest and Wildlife Area
woodson-k-woods-memorial-conservation-area	Woodson K. Woods Memorial Conservation Area
hartwell-conservation-area	Hartwell Conservation Area
tea-access	Tea Access
tri-city-community-lake	Tri-City Community Lake
big-john-access	Big John Access
maramec-spring-fish-hatchery	Maramec Spring Fish Hatchery
maramec-spring-park	Maramec Spring Park
blue-lick-conservation-area	Blue Lick Conservation Area
hyer-woods-conservation-area	Hyer Woods Conservation Area
peter-eck-conservation-area	Peter A. Eck Conservation Area
loutre-lick-access	Loutre Lick Access
hungry-mother-conservation-area	Hungry Mother Conservation Area
rudolf-bennitt-conservation-area	Rudolf Bennitt Conservation Area
truman-reservoir-management-lands-cedar-creek	Truman Reservoir Management Lands (Cedar Creek)
hermann-riverfront-park	Hermann Riverfront Park
scotts-ford-access	Scotts Ford Access
sentinel-conservation-area	Sentinel Conservation Area
mcallister-springs-access	McAllister Springs Access
stump-island-park-access	Stump Island Park Access
truman-reservoir-management-lands-upper-tebo-creek	Truman Reservoir Management Lands (Upper Tebo Creek)
danville-conservation-area	Danville Conservation Area
william-lowe-conservation-area	William Lowe Conservation Area
riverview-access	Riverview Access
lakeview-park-lake-mexico	Lakeview Park Lake (Mexico)
teal-lake-mexico	Teal Lake (Mexico)
john-alva-fuson-md-conservation-area	John Alva Fuson, MD Conservation Area
lenox-towersite	Lenox Towersite
mill-rock-access	Mill Rock Access
marshall-lake-minesa	Marshall (Lake Minesa)
clarence-l-northcutt-memorial-conservation-area	Clarence L. Northcutt Memorial Conservation Area
truman-reservoir-management-lands-gouge-eye	Truman Reservoir Management Lands (Gouge Eye)
pomme-de-terre-lake-management-lands	Pomme De Terre Lake Management Lands
rader-access	Rader Access
goose-creek-conservation-area	Goose Creek Conservation Area
kiwanis-lake-mexico	Kiwanis Lake (Mexico)
george-o-white-state-forest-nursery	George O. White State Forest Nursery
charity-access	Charity Access
lewis-mill-access	Lewis Mill Access
marshall-amary-lake	Marshall (Amary Lake)
mason-bridge-access	Mason Bridge Access
white-river-trace-conservation-area	White River Trace Conservation Area
port-hudson-lake-conservation-area	Port Hudson Lake Conservation Area
gerhild-graham-brown-conservation-area	Gerhild and Graham Brown Conservation Area
marshall-i-diggs-conservation-area	Marshall I. Diggs Conservation Area
wenkel-ford-access	Wenkel Ford Access
daniel-boone-conservation-area	Daniel Boone Conservation Area
connor-o-fewel-conservation-area	Connor O. Fewel Conservation Area
wellsville-lake-conservation-area	Wellsville Lake Conservation Area
blind-pony-lake-conservation-area	Blind Pony Lake Conservation Area
kings-prairie-access	Kings Prairie Access
wilbur-allen-memorial-conservation-area	Wilbur Allen Memorial Conservation Area
niangua-conservation-area	Niangua Conservation Area
crooked-creek-conservation-area	Crooked Creek Conservation Area
boiling-spring-access	Boiling Spring Access
truman-reservoir-management-lands-bethlehem	Truman Reservoir Management Lands (Bethlehem)
noser-mill-conservation-area	Noser Mill Conservation Area
ralph-martha-perry-memorial-conservation-area	Ralph and Martha Perry Memorial Conservation Area
twenty-five-mile-prairie-conservation-area	Twenty-Five Mile Prairie Conservation Area
truman-reservoir-management-lands-brownington	Truman Reservoir Management Lands (Brownington)
little-lost-creek-conservation-area	Little Lost Creek Conservation Area
clinton-office	Clinton Office
keysville-towersite	Keysville Towersite
dave-rock-conservation-area	Dave Rock Conservation Area
linscomb-wildlife-area	Linscomb Wildlife Area
truman-reservoir-management-lands-gallinipper-creek	Truman Reservoir Management Lands (Gallinipper Creek)
truman-reservoir-management-lands-little-pomme-de-terre	Truman Reservoir Management Lands (Little Pomme de Terre)
truman-reservoir-management-lands-valhalla	Truman Reservoir Management Lands (Valhalla)
truman-reservoir-management-lands-weaubleau-creek	Truman Reservoir Management Lands (Weaubleau Creek)
new-haven-access	New Haven Access
dalton-bottoms-access	Dalton Bottoms Access
john-n-melba-s-anderson-memorial-conservation-area	John N. and Melba S. Anderson Memorial Conservation Area
short-bend-access	Short Bend Access
long-ridge-conservation-area	Long Ridge Conservation Area
huzzah-conservation-area	Huzzah Conservation Area
edwin-pape-lake-concordia	Edwin A. Pape Lake (Concordia)
buzzard-bluff-access	Buzzard Bluff Access
moberly-beuth-park-lake	Moberly (Beuth Park Lake)
sunset-park-access	Sunset Park Access
montauk-towersite	Montauk Towersite
blue-springs-creek-conservation-area	Blue Springs Creek Conservation Area
shawnee-mac-lakes-conservation-area	Shawnee Mac Lakes Conservation Area
pearl-g-john-j-sizemore-memorial-conservation-area	Pearl G. and John J. Sizemore Memorial Conservation Area
indian-trail-conservation-area	Indian Trail Conservation Area
colters-landing-access	Colter&#039;s Landing Access
truman-reservoir-management-lands-grand-river-bottoms	Truman Reservoir Management Lands (Grand River Bottoms)
rothwell-park-lake-moberly	Rothwell Park Lake (Moberly)
water-works-lake-moberly	Water Works Lake (Moberly)
truman-reservoir-management-lands-deepwater-creek	Truman Reservoir Management Lands (Deepwater Creek)
brush-creek-conservation-area	Brush Creek Conservation Area
robert-m-white-ii-conservation-area	Robert M. White II Conservation Area
lions-lake-warrensburg	Lions Lake (Warrensburg)
pine-ridge-lake-salisbury	Pine Ridge Lake (Salisbury)
sterling-price-community-lake	Sterling Price Community Lake
bolivar-forestry-office	Bolivar Forestry Office
f-o-leda-j-sears-memorial-wildlife-area	F. O. and Leda J. Sears Memorial Wildlife Area
lamberson-memorial-conservation-area	Lamberson Memorial Conservation Area
houston-towersite	Houston Towersite
lichen-glade-conservation-area	Lichen Glade Conservation Area
malta-bend-community-lake	Malta Bend Community Lake
haysler-poague-conservation-area	Haysler A. Poague Conservation Area
campbell-bridge-access	Campbell Bridge Access
mineral-springs-access	Mineral Springs Access
truman-reservoir-management-lands-sac-osage	Truman Reservoir Management Lands (Sac Osage)
chapel-view-prairie-conservation-area	Chapel View Prairie Conservation Area
onyx-cave-conservation-area	Onyx Cave Conservation Area
horseshoe-bend-natural-area	Horseshoe Bend Natural Area
birdsong-conservation-area	Birdsong Conservation Area
la-petite-gemme-prairie-conservation-area	La Petite Gemme Prairie Conservation Area
sugar-creek-lake-moberly	Sugar Creek Lake (Moberly)
sappington-bridge-access	Sappington Bridge Access
p-f-barnes-conservation-area	P. F. Barnes Conservation Area
truman-reservoir-management-lands-salt-creek	Truman Reservoir Management Lands (Salt Creek)
la-due-bottoms-conservation-area	La Due Bottoms Conservation Area
reiker-ford-access	Reiker Ford Access
odin-access	Odin Access
sand-ford-access	Sand Ford Access
camp-branch-access	Camp Branch Access
dogs-bluff-access	Dogs Bluff Access
montauk-fish-hatchery	Montauk Fish Hatchery
meramec-conservation-area	Meramec Conservation Area
piney-river-narrows-natural-area	Piney River Narrows Natural Area
grand-pass-conservation-area	Grand Pass Conservation Area
turkey-creek-conservation-area	Turkey Creek Conservation Area
blackjack-access	Blackjack Access
cedar-bluff-access	Cedar Bluff Access
miami-access	Miami Access
mayers-landing-access	Mayers Landing Access
hazel-hill-lake	Hazel Hill Lake
maxwell-taylor-park-pond-keytesville	Maxwell Taylor Park Pond (Keytesville)
santa-fe-access	Santa Fe Access
vandalia-community-lake	Vandalia Community Lake
lois-arlene-boesl-outdoor-education-area	Lois Arlene Boesl Outdoor Education Area
pleasant-hope-conservation-area	Pleasant Hope Conservation Area
union-city-lake	Union City Lake
washington-lions-lake	Washington (Lion&#039;s Lake)
urich-conservation-area	Urich Conservation Area
frank-emma-elizabeth-edna-reifsnider-state-forest	Frank, Emma Elizabeth and Edna Reifsnider State Forest
higginsville-city-lake	Higginsville City Lake
union-access	Union Access
mckinny-conservation-area	McKinny Conservation Area
ruby-clark-willingham-memorial-wildlife-area	Ruby Clark Willingham Memorial Wildlife Area
baptist-camp-access	Baptist Camp Access
bluff-springs-conservation-area	Bluff Springs Conservation Area
brunswick-access	Brunswick Access
montrose-conservation-area	Montrose Conservation Area
caldwell-memorial-wildlife-area	Caldwell Memorial Wildlife Area
paris-access	Paris Access
stockton-lake-management-lands	Stockton Lake Management Lands
millsap-bridge-access	Millsap Bridge Access
simmons-ford-access	Simmons Ford Access
woodlawn-access	Woodlawn Access
fellows-lake-springfield-city-utilities	Fellows Lake (Springfield City Utilities)
pea-ridge-conservation-area	Pea Ridge Conservation Area
urich-access	Urich Access
dale-sare-conservation-area	Dale Sare Conservation Area
baltimore-bend-conservation-area	Baltimore Bend Conservation Area
maple-leaf-lake-conservation-area	Maple Leaf Lake Conservation Area
little-indian-creek-conservation-area	Little Indian Creek Conservation Area
compton-hollow-conservation-area	Compton Hollow Conservation Area
little-sac-woods-conservation-area	Little Sac Woods Conservation Area
redhorse-access	Redhorse Access
cedar-grove-conservation-area	Cedar Grove Conservation Area
austin-community-lake	Austin Community Lake
dr-henry-amalia-uhlemeyer-access	Dr. Henry A. and Amalia Uhlemeyer Access
cabool-towersite	Cabool Towersite
taberville-prairie-conservation-area	Taberville Prairie Conservation Area
chouteau-claim-access	Chouteau Claim Access
river-round-conservation-area	River &#039;Round Conservation Area
taberville-access	Taberville Access
helen-k-wiese-conservation-area	Helen K. Wiese Conservation Area
bee-hollow-conservation-area	Bee Hollow Conservation Area
thomas-hill-reservoir-conservation-area	Thomas Hill Reservoir Conservation Area
blue-slip-towersite	Blue Slip Towersite
valley-water-mill-lake-watershed-committee-ozarks	Valley Water Mill Lake (Watershed Committee of the Ozarks)
bosworth-access	Bosworth Access
southwest-regional-office	Southwest Regional Office
cedar-gap-conservation-area	Cedar Gap Conservation Area
rocky-barrens-conservation-area	Rocky Barrens Conservation Area
monegaw-prairie-conservation-area	Monegaw Prairie Conservation Area
wahkon-tah-prairie	Wah&#039;Kon-Tah Prairie
holden-city-lake	Holden City Lake
schell-osage-conservation-area	Schell-Osage Conservation Area
ashley-access	Ashley Access
summersville-towersite	Summersville Towersite
midvale-conservation-area	Midvale Conservation Area
community-club-lake-wentzville	Community Club Lake (Wentzville)
settles-ford-conservation-area	Settle&#039;s Ford Conservation Area
gist-ranch-conservation-area	Gist Ranch Conservation Area
r-h-crouch-access	R. H. Crouch Access
el-dorado-springs-office	El Dorado Springs Office
odessa-lake-venita	Odessa (Lake Venita)
corry-flatrocks-conservation-area	Corry Flatrocks Conservation Area
phenix-access	Phenix Access
odessa-upper-odessa-lake	Odessa (Upper Odessa Lake)
odessa-city-lake	Odessa City Lake
little-compton-lake-conservation-area	Little Compton Lake Conservation Area
heartland-lake-wentzville	Heartland Lake (Wentzville)
sky-prairie-conservation-area	Sky Prairie Conservation Area
joe-crighton-access	Joe Crighton Access
catawissa-conservation-area	Catawissa Conservation Area
vonaventure-memorial-forest-wildlife-area	Vonaventure Memorial Forest and Wildlife Area
engelmann-woods-natural-area	Engelmann Woods Natural Area
blees-lake-macon	Blees Lake (Macon)
yellow-creek-conservation-area	Yellow Creek Conservation Area
bois-darc-conservation-area	Bois D&#039;Arc Conservation Area
august-busch-shooting-range-outdoor-education-center	August A. Busch Shooting Range and Outdoor Education Center
andy-dalton-shooting-range-outdoor-education-center	Andy Dalton Shooting Range and Outdoor Education Center
marceline-city-lake	Marceline City Lake
nannie-b-floyd-memorial-conservation-area	Nannie B. Floyd Memorial Conservation Area
sunklands-conservation-area	Sunklands Conservation Area
lexington-riverfront-park	Lexington Riverfront Park
pacific-palisades-conservation-area	Pacific Palisades Conservation Area
william-r-logan-conservation-area	William R. Logan Conservation Area
w-l-schifferdecker-memorial-conservation-area	W. L. Schifferdecker Memorial Conservation Area
hunnewell-access	Hunnewell Access
springfield-conservation-nature-center	Springfield Conservation Nature Center
hardin-conservation-area	Hardin Conservation Area
ferguson-herold-conservation-area	Ferguson-Herold Conservation Area
route-j-reservoir-monroe-city	Route J Reservoir (Monroe City)
macon-city-lake	Macon City Lake
labarque-creek-conservation-area	LaBarque Creek Conservation Area
august-busch-memorial-conservation-area	August A. Busch Memorial Conservation Area
mound-view-access	Mound View Access
rockwoods-range	Rockwoods Range
browns-ford-access	Brown&#039;s Ford Access
old-marceline-city-reservoir-marceline	Old Marceline City Reservoir (Marceline)
william-g-erma-parke-white-memorial-wildlife-area	William G. and Erma Parke White Memorial Wildlife Area
kessler-memorial-wildlife-area	Kessler Memorial Wildlife Area
merrill-horse-access	Merrill Horse Access
roger-bilderback-lake-potosi	Roger Bilderback Lake (Potosi)
myron-sonya-glassberg-family-conservation-area	Myron and Sonya Glassberg Family Conservation Area
sumner-access	Sumner Access
kingston-access	Kingston Access
west-lake-bowling-green	West Lake (Bowling Green)
arrow-wood-conservation-area	Arrow-Wood Conservation Area
south-prong-access	South Prong Access
james-r-harter-conservation-area	James R. Harter Conservation Area
jack-floyd-memorial-lake-bowling-green	Jack Floyd Memorial Lake (Bowling Green)
young-conservation-area	Young Conservation Area
mussel-fork-conservation-area	Mussel Fork Conservation Area
allenton-access	Allenton Access
weldon-spring-conservation-area	Weldon Spring Conservation Area
hunnewell-lake-conservation-area	Hunnewell Lake Conservation Area
shannon-ranch-conservation-area	Shannon Ranch Conservation Area
pin-oak-conservation-area	Pin Oak Conservation Area
ranacker-conservation-area	Ranacker Conservation Area
fiddlers-ford-access	Fiddlers Ford Access
mammoth-access	Mammoth Access
sni-bar-conservation-area	Sni-A-Bar Conservation Area
august-busch-jr-memorial-wetlands-four-rivers-conservation-area	August A. Busch Jr. Memorial Wetlands at Four Rivers Conservation Area
howell-island-conservation-area	Howell Island Conservation Area
lone-jack-lake-conservation-area	Lone Jack Lake Conservation Area
rockwoods-reservation	Rockwoods Reservation
vera-cruz-access	Vera Cruz Access
sims-valley-community-lake	Sims Valley Community Lake
bootleg-access	Bootleg Access
niawathe-prairie-conservation-area	Niawathe Prairie Conservation Area
washington-state-park-access-mo-dnr	Washington State Park Access (MO DNR)
porter-park-lake-pleasant-hill	Porter Park Lake (Pleasant Hill)
valley-view-glades-natural-area	Valley View Glades Natural Area
barn-hollow-natural-area	Barn Hollow Natural Area
griffiths-memorial-conservation-area	Griffiths Memorial Conservation Area
grundy-memorial-wildlife-area	Grundy Memorial Wildlife Area
fred-bollow-conservation-area	Fred Bollow Conservation Area
stony-point-prairie-conservation-area	Stony Point Prairie Conservation Area
dodd-access	Dodd Access
bunch-hollow-conservation-area	Bunch Hollow Conservation Area
ripgut-prairie-natural-area	Ripgut Prairie Natural Area
rippee-conservation-area	Rippee Conservation Area
gay-feather-prairie-conservation-area	Gay Feather Prairie Conservation Area
route-66-state-park-access-mo-dnr	Route 66 State Park Access (MO DNR)
harrisonville-upper-lake	Harrisonville (Upper Lake)
richard-massengill-conservation-area	Richard Massengill Conservation Area
dr-o-e-eloise-sloan-conservation-area	Dr. O. E. and Eloise Sloan Conservation Area
mountain-view-towersite	Mountain View Towersite
brookfield-city-lake	Brookfield City Lake
harrisonville-lake-luna	Harrisonville (Lake Luna)
fountain-grove-conservation-area	Fountain Grove Conservation Area
old-town-access	Old Town Access
pleasant-hill-city-lake	Pleasant Hill City Lake
redman-conservation-area	Redman Conservation Area
elmslie-memorial-conservation-area	Elmslie Memorial Conservation Area
hughes-mountain-natural-area	Hughes Mountain Natural Area
sons-creek-conservation-area	Sons Creek Conservation Area
angeline-conservation-area	Angeline Conservation Area
roger-klamberg-woods-conservation-area	Roger Klamberg Woods Conservation Area
buttin-rock-access	Buttin Rock Access
delaware-town-access	Delaware Town Access
indigo-prairie-conservation-area	Indigo Prairie Conservation Area
joshua-t-chilton-memorial-landing-eminence	Joshua T. Chilton Memorial Landing (Eminence)
indian-camp-access	Indian Camp Access
frank-e-wagner-conservation-area	Frank E. Wagner Conservation Area
north-lake-harrisonville	North Lake (Harrisonville)
cuivre-island-conservation-area	Cuivre Island Conservation Area
wade-june-shelton-memorial-conservation-area	Wade and June Shelton Memorial Conservation Area
centerville-access	Centerville Access
bristow-conservation-area	Bristow Conservation Area
two-rivers-access-ozark-national-scenic-riverways	Two Rivers Access (Ozark National Scenic Riverways)
ray-county-community-lake	Ray County Community Lake
paris-springs-access	Paris Springs Access
atlanta-conservation-area	Atlanta Conservation Area
long-branch-lake-management-lands	Long Branch Lake Management Lands
new-ballwin-park-lake-ballwin	New Ballwin Park Lake (Ballwin)
jay-henges-shooting-range-outdoor-education-center	Jay Henges Shooting Range and Outdoor Education Center
bittern-bottoms-conservation-area	Bittern Bottoms Conservation Area
squires-towersite	Squires Towersite
lake-remembrance-blue-springs	Lake Remembrance  (Blue Springs)
dorsett-hill-prairie-conservation-area	Dorsett Hill Prairie Conservation Area
victoria-glades-conservation-area	Victoria Glades Conservation Area
sandy-island-conservation-area	Sandy Island Conservation Area
horse-creek-prairie-conservation-area	Horse Creek Prairie Conservation Area
jim-bridger-urban-conservation-area	Jim Bridger Urban Conservation Area
vlasis-park-lake-ballwin	Vlasis Park Lake (Ballwin)
butler-city-lake	Butler City Lake
cephas-ford-access	Cephas Ford Access
dean-davis-conservation-area	Dean Davis Conservation Area
gama-grass-prairie-conservation-area	Gama Grass Prairie Conservation Area
shelvin-rock-access	Shelvin Rock Access
amarugia-highlands-conservation-area	Amarugia Highlands Conservation Area
dorothy-e-aselman-memorial-addition-forest-44-conservation-area	Dorothy E. Aselman Memorial Addition to Forest 44 Conservation Area
james-reed-memorial-wildlife-area	James A. Reed Memorial Wildlife Area
forest-44-conservation-area	Forest 44 Conservation Area
lake-city-shooting-range-outdoor-education-center	Lake City Shooting Range and Outdoor Education Center
edward-b-marie-o-risch-conservation-area	Edward B. and Marie O. Risch Conservation Area
balltown-access	Balltown Access
prairie-lee-lake-jackson-county	Prairie Lee Lake (Jackson County)
hebron-access	Hebron Access
ted-shanks-conservation-area	Ted Shanks Conservation Area
august-g-beckemeier-conservation-area	August G. Beckemeier Conservation Area
douglas-branch-conservation-area	Douglas Branch Conservation Area
piggs-landing-access	Pigg&#039;s Landing Access
callahan-mound-access	Callahan Mound Access
burr-oak-woods-conservation-area	Burr Oak Woods Conservation Area
dupont-reservation-conservation-area	Dupont Reservation Conservation Area
pawhuska-prairie	Pawhuska Prairie
calumet-creek-access	Calumet Creek Access
buford-mountain-conservation-area	Buford Mountain Conservation Area
harmony-mission-lake-conservation-area	Harmony Mission Lake Conservation Area
b-k-leach-memorial-conservation-area	B. K. Leach Memorial Conservation Area
peabody-conservation-area	Peabody Conservation Area
chesapeake-fish-hatchery	Chesapeake Fish Hatchery
leadwood-access	Leadwood Access
fort-osage-county-park-jackson-county	Fort Osage County Park (Jackson County)
izaac-walton-lake-nevada	Izaac Walton Lake (Nevada)
hannibal-huckleberry-lake	Hannibal (Huckleberry Lake)
edward-anderson-conservation-area	Edward Anderson Conservation Area
lake-jacomo-jackson-county	Lake Jacomo (Jackson County)
logan-creek-conservation-area	Logan Creek Conservation Area
jarville-lake-st-louis-county	Jarville Lake (St. Louis County)
clear-creek-conservation-area	Clear Creek Conservation Area
bonne-terre-city-lake	Bonne Terre City Lake
simpson-park-lake-st-louis-county	Simpson Park Lake (St. Louis County)
meramec-landing-valley-park	Meramec Landing (Valley Park)
westside-park-lake-fenton	Westside Park Lake (Fenton)
prairie-slough-conservation-area	Prairie Slough Conservation Area
clarksville-riverfront-park	Clarksville Riverfront Park
bismarck-conservation-area	Bismarck Conservation Area
little-osage-prairie	Little Osage Prairie
robert-h-thompson-conservation-area	Robert H. Thompson Conservation Area
blue-springs-lake-jackson-county	Blue Springs Lake (Jackson County)
radio-springs-lake-nevada	Radio Springs Lake (Nevada)
crooked-river-conservation-area	Crooked River Conservation Area
phantom-forest-conservation-area	Phantom Forest Conservation Area
skate-park-lake-st-charles	Skate Park Lake (St. Charles)
preslar-lake-fenton	Preslar Lake (Fenton)
osage-prairie-conservation-area	Osage Prairie Conservation Area
moore-lake-st-charles	Moore Lake (St. Charles)
kluesner-lake-st-charles	Kluesner Lake (St. Charles)
fountain-lakes-pond-st-charles	Fountain Lakes Pond (St. Charles)
j-thad-ray-memorial-wildlife-area	J. Thad Ray Memorial Wildlife Area
upper-fabick-lake-fenton	Upper Fabick Lake (Fenton)
mcgennis-youth-center-lake	McGennis Youth Center Lake
jean-joan-goodson-conservation-area	Jean and Joan Goodson Conservation Area
creve-coeur-park-lake-st-louis-county	Creve Coeur Park Lake (St. Louis County)
hooten-town-access	Hooten Town Access
dr-harry-lina-berrier-memorial-conservation-area	Dr. Harry and Lina Berrier Memorial Conservation Area
raymore-recreation-park-pond	Raymore (Recreation Park Pond)
flight-lake-conservation-area	Flight Lake Conservation Area
mount-vernon-prairie	Mount Vernon Prairie
emmenegger-nature-park	Emmenegger Nature Park
possum-woods-conservation-area	Possum Woods Conservation Area
julian-steyermark-woods-conservation-area	Julian Steyermark Woods Conservation Area
lesterville-access	Lesterville Access
hamburg-ferry-access	Hamburg Ferry Access
powder-valley-conservation-nature-center	Powder Valley Conservation Nature Center
dunn-ford-access	Dunn Ford Access
busiek-state-forest-wildlife-area	Busiek State Forest and Wildlife Area
black-hawk-access	Black Hawk Access
thomasville-towersite	Thomasville Towersite
buffalo-wallow-prairie-conservation-area	Buffalo Wallow Prairie Conservation Area
providence-prairie-conservation-area	Providence Prairie Conservation Area
johnston-lake-raymore	Johnston Lake (Raymore)
coval-gann-chillicothe-access	Coval Gann - Chillicothe Access
blanchette-landing-access	Blanchette Landing Access
cooley-lake-conservation-area	Cooley Lake Conservation Area
kirkwood-walker-lake	Kirkwood (Walker Lake)
rocky-creek-conservation-area	Rocky Creek Conservation Area
akerson-access-palmyra	(Akerson Access) Palmyra
holland-state-forest	Holland State Forest
treaty-line-prairie-conservation-area	Treaty Line Prairie Conservation Area
hayes-spring-conservation-area	Hayes Spring Conservation Area
hidden-hollow-conservation-area	Hidden Hollow Conservation Area
ketcherside-mountain-conservation-area	Ketcherside Mountain Conservation Area
island-lake-st-louis-county	Island Lake (St. Louis County)
carp-lake-st-louis-county	Carp Lake (St. Louis County)
kickapoo-prairie-conservation-area	Kickapoo Prairie Conservation Area
foxglove-conservation-area	Foxglove Conservation Area
birch-creek-conservation-area	Birch Creek Conservation Area
robert-e-talbot-conservation-area	Robert E. Talbot Conservation Area
claire-gempp-davidson-memorial-wildlife-area	Claire Gempp Davidson Memorial Wildlife Area
current-river-conservation-area	Current River Conservation Area
la-plata-city-lake	La Plata City Lake
jackson-county-longview-lake	Jackson County (Longview Lake)
mcpike-access	McPike Access
quarry-pond-mineral-area-college	Quarry Pond (Mineral Area College)
mineral-area-college-range	Mineral Area College Range
twin-pines-conservation-education-center	Twin Pines Conservation Education Center
teszars-woods-conservation-area	Teszars Woods Conservation Area
pa-sole-prairie-conservation-area	Pa Sole Prairie Conservation Area
flamm-city-access	Flamm City Access
hickory-woods-conservation-area	Hickory Woods Conservation Area
st-ann-gendron-lake	St. Ann (Gendron Lake)
white-oak-bend-access	White Oak Bend Access
wild-acres-park-lake-overland	Wild Acres Park Lake (Overland)
lipton-conservation-area	Lipton Conservation Area
big-drywood-creek-conservation-area	Big Drywood Creek Conservation Area
sycamore-access	Sycamore Access
blue-jay-trail-access	Blue Jay Trail Access
peck-ranch-conservation-area	Peck Ranch Conservation Area
tilles-park-lake-st-louis-county	Tilles Park Lake (St. Louis County)
belton-cleveland-lake	Belton (Cleveland Lake)
bushwhacker-lake-conservation-area	Bushwhacker Lake Conservation Area
carrick-w-davidson-robert-g-paris-wildlife-area	Carrick W. Davidson - Robert G. Paris Wildlife Area
bee-tree-park-lake-st-louis-county	Bee Tree Park Lake (St. Louis County)
saint-stanislaus-conservation-area	Saint Stanislaus Conservation Area
henry-sever-lake-conservation-area	Henry Sever Lake Conservation Area
wire-road-conservation-area	Wire Road Conservation Area
cleveland-clear-springs-lake	Cleveland (Clear Springs Lake)
fabius-chute-access	Fabius Chute Access
labenite-park-sugar-creek	LaBenite Park (Sugar Creek)
caney-mountain-conservation-area	Caney Mountain Conservation Area
liberty-bend-conservation-area	Liberty Bend Conservation Area
montgomery-woods-conservation-area	Montgomery Woods Conservation Area
dorris-creek-prairie-conservation-area	Dorris Creek Prairie Conservation Area
marais-temps-clair-conservation-area	Marais Temps Clair Conservation Area
ozark-regional-office	Ozark Regional Office
soulard-access	Soulard Access
mo-no-i-prairie-conservation-area	Mo-No-I Prairie Conservation Area
liberty-capitol-federal-sports-complex-pond-1	Liberty (Capitol Federal Sports Complex Pond 1)
liberty-capitol-federal-sports-complex-pond-2	Liberty (Capitol Federal Sports Complex Pond 2)
liberty-capitol-federal-sports-complex-pond-3	Liberty (Capitol Federal Sports Complex Pond 3)
liberty-capitol-federal-sports-complex-pond-4	Liberty (Capitol Federal Sports Complex Pond 4)
liberty-capitol-federal-sports-complex-pond-5	Liberty (Capitol Federal Sports Complex Pond 5)
liberty-capitol-federal-sports-complex-pond-6	Liberty (Capitol Federal Sports Complex Pond 6)
liberty-capitol-federal-sports-complex-pond-7	Liberty (Capitol Federal Sports Complex Pond 7)
liberty-capitol-federal-sports-complex-pond-8	Liberty (Capitol Federal Sports Complex Pond 8)
hager-lake-farmington	Hager Lake (Farmington)
warren-bridge-access	Warren Bridge Access
bonanza-conservation-area	Bonanza Conservation Area
clearwater-lake-management-lands	Clearwater Lake Management Lands
saeger-woods-conservation-area	Saeger Woods Conservation Area
smith-lake-kansas-city	Smith Lake (Kansas City)
lake-woods-kansas-city	Lake of the Woods (Kansas City)
gravois-creek-conservation-area	Gravois Creek Conservation Area
north-lake-st-louis	North Lake (St. Louis)
h-l-kerr-access	H. L. Kerr Access
south-lake-st-louis	South Lake (St. Louis)
giessing-lake-farmington	Giessing Lake (Farmington)
walnut-woods-conservation-area	Walnut Woods Conservation Area
blair-bridge-access	Blair Bridge Access
thomas-lake-farmington	Thomas Lake (Farmington)
brown-athletic-field-access-jackson-county	Brown Athletic Field Access (Jackson County)
lawson-city-lake	Lawson City Lake
gruner-ford-access	Gruner Ford Access
farmington-asher-lake	Farmington (Asher Lake)
january-wabash-park-lake-ferguson	January-Wabash Park Lake (Ferguson)
rush-creek-conservation-area	Rush Creek Conservation Area
patrick-bridge-access	Patrick Bridge Access
lewis-family-dean-anna-mae-david-d-lewis-memorial-conservation-area	The Lewis Family, Dean, Anna Mae and David D. Lewis Memorial Conservation Area
horseshoe-lake-st-louis	Horseshoe Lake (St. Louis)
roselle-access	Roselle Access
blue-valley-lake-kansas-city	Blue Valley Lake (Kansas City)
funk-memorial-state-forest-wildlife-area	Funk Memorial State Forest and Wildlife Area
redwing-prairie-conservation-area	Redwing Prairie Conservation Area
boathouse-lake-st-louis	Boathouse Lake (St. Louis)
migliazzo-lake-kansas-city	Migliazzo Lake (Kansas City)
comstock-prairie-conservation-area	Comstock Prairie Conservation Area
ralph-cox-memorial-access	Ralph Cox Memorial Access
truman-access	Truman Access
la-russell-access	La Russell Access
jefferson-lake-st-louis	Jefferson Lake (St. Louis)
bull-shoals-lake-management-lands	Bull Shoals Lake Management Lands
rockaway-beach-access	Rockaway Beach Access
sugar-creek-conservation-area-0	Sugar Creek Conservation Area
riverside-conservation-area	Riverside Conservation Area
elmer-cook-memorial-access	Elmer A. Cook Memorial Access
flo-cook-access	Flo Cook Access
syenite-access	Syenite Access
boston-ferry-conservation-area	Boston Ferry Conservation Area
anita-b-gorman-conservation-discovery-center	The Anita B. Gorman Conservation Discovery Center
millstream-gardens-conservation-area	Millstream Gardens Conservation Area
koeneman-park-lake-jennings	Koeneman Park Lake (Jennings)
branson-forestry-office	Branson Forestry Office
troost-lake-kansas-city	Troost Lake (Kansas City)
tecumseh-towersite	Tecumseh Towersite
north-terrace-lake-kansas-city	North Terrace Lake (Kansas City)
labelle-lake-conservation-area	LaBelle Lake Conservation Area
rocky-ford-access	Rocky Ford Access
kansas-city-riverfront-park-access	Kansas City Riverfront Park Access
benton-park-lake-st-louis	Benton Park Lake (St. Louis)
jessie-hollow-conservation-area	Jessie Hollow Conservation Area
hickory-canyons-natural-area	Hickory Canyons Natural Area
bethel-prairie-conservation-area	Bethel Prairie Conservation Area
tolona-access	Tolona Access
blackjack-lake-st-louis-county	Blackjack Lake (St. Louis County)
bull-shoals-lake-beaver-creek-public-access-us-army-corps-engineers	Bull Shoals Lake, Beaver Creek Public Access (U.S. Army Corps of Engineers)
lafayette-park-lake-st-louis	Lafayette Park Lake (St. Louis)
fairgrounds-park-lake-st-louis	Fairgrounds Park Lake (St. Louis)
pelican-island-access	Pelican Island Access
pelican-island-natural-area	Pelican Island Natural Area
knob-lick-towersite	Knob Lick Towersite
fountain-lake-st-louis-county	Fountain Lake (St. Louis County)
northeast-regional-office	Northeast Regional Office
ofallon-park-lake-st-louis	O&#039;Fallon Park Lake (St. Louis)
lakewood-lake-kansas-city	Lakewood Lake (Kansas City)
bellefontaine-conservation-area	Bellefontaine Conservation Area
van-buren-riverfront-park	Van Buren Riverfront Park
penn-valley-lake-kansas-city	Penn Valley Lake (Kansas City)
drywood-conservation-area	Drywood Conservation Area
chaumiere-lake-kansas-city	Chaumiere Lake (Kansas City)
poosey-conservation-area	Poosey Conservation Area
kearney-jesse-james-park-lake	Kearney (Jesse James Park Lake)
bull-shoals-lake-theodsia-public-access-us-army-corps-engineers	Bull Shoals Lake, Theodsia Public Access (U.S. Army Corps of Engineers)
timber-knob-towersite	Timber Knob Towersite
pickle-springs-natural-area	Pickle Springs Natural Area
punkin-center-access	Punkin Center Access
big-creek-conservation-area	Big Creek Conservation Area
upper-mississippi-conservation-area	Upper Mississippi Conservation Area
horton-farm-conservation-area	Horton Farm Conservation Area
clearwater-conservation-area	Clearwater Conservation Area
miller-community-lake	Miller Community Lake
tingler-prairie-conservation-area	Tingler Prairie Conservation Area
carter-creek-conservation-area	Carter Creek Conservation Area
bull-shoals-lake-highway-k-public-access-us-army-corps-engineers	Bull Shoals Lake, Highway K Public Access (U.S. Army Corps of Engineers
englewood-lake-kansas-city	Englewood Lake (Kansas City)
spanish-lake-st-louis-county	Spanish Lake (St. Louis County)
hamilton-city-lake	Hamilton City Lake
ruth-paul-henning-conservation-area	Ruth and Paul Henning Conservation Area
maple-woods-natural-area	Maple Woods Natural Area
norfork-lake-udall-public-access-us-army-corps-engineers	Norfork Lake, Udall Public Access (U.S. Army Corps of Engineers)
sunfish-lake-st-louis-county	Sunfish Lake (St. Louis County)
spur-pond-kirksville	Spur Pond (Kirksville)
bull-shoals-lake-spring-creek-public-access-us-army-corps-engineers	Bull Shoals Lake, Spring Creek Public Access (U.S. Army Corps of Engineers)
newman-memorial-access	Newman Memorial Access
columbia-bottom-conservation-area	Columbia Bottom Conservation Area
lon-sanders-canyon-conservation-area	Lon Sanders Canyon Conservation Area
lower-flat-creek-access	Lower Flat Creek Access
gallatin-conservation-area	Gallatin Conservation Area
cooper-creek-access	Cooper Creek Access
kellogg-lake-carthage	Kellogg Lake (Carthage)
norfork-lake-management-lands	Norfork Lake Management Lands
thompson-ford-access	Thompson Ford Access
clearwater-district-headquarters	Clearwater District Headquarters
dan-maureen-cover-memorial-wildlife-area	Dan and Maureen Cover Memorial Wildlife Area
magnolia-hollow-conservation-area	Magnolia Hollow Conservation Area
stubblefield-access	Stubblefield Access
lester-r-davis-memorial-forest	The Lester R. Davis Memorial Forest
sunnyside-school-access	Sunnyside School Access
archie-gracie-vanderhoef-memorial-state-forest	Archie and Gracie Vanderhoef Memorial State Forest
henry-truitt-access	Henry Truitt Access
drury-mincy-conservation-area	Drury-Mincy Conservation Area
white-ranch-conservation-area	White Ranch Conservation Area
alton-forestry-sub-office	Alton Forestry Sub-Office
dan-maureen-cover-prairie-conservation-area	Dan and Maureen Cover Prairie Conservation Area
graves-mountain-conservation-area	Graves Mountain Conservation Area
fredericktown-city-lake	Fredericktown City Lake
deer-ridge-conservation-area	Deer Ridge Conservation Area
shepherd-hills-conservation-education-center	Shepherd of the Hills Conservation Education Center
locust-creek-conservation-area	Locust Creek Conservation Area
warm-fork-conservation-area	Warm Fork Conservation Area
holmes-bend-access	Holmes Bend Access
shawnee-trail-conservation-area	Shawnee Trail Conservation Area
ashe-juniper-natural-area	Ashe Juniper Natural Area
parkville-platte-landing-park	Parkville (Platte Landing Park)
white-alloe-creek-conservation-area	White Alloe Creek Conservation Area
hollister-towersite	Hollister Towersite
coldwater-access	Coldwater Access
hazel-creek-lake-kirksville	Hazel Creek Lake (Kirksville)
smithville-helvey-park-lake	Smithville (Helvey Park Lake)
flatwoods-conservation-area	Flatwoods Conservation Area
smithville-lake-remote	Smithville (Lake Remote)
elmwood-lake-milan	Elmwood Lake (Milan)
lathrop-bridge-access	Lathrop Bridge Access
mcgee-family-conservation-area	McGee Family Conservation Area
wabash-crossing-access	Wabash Crossing Access
shoemaker-conservation-area	Shoemaker Conservation Area
mockingbird-hill-access	Mockingbird Hill Access
wyaconda-crossing-conservation-area	Wyaconda Crossing Conservation Area
ronald-maude-hartell-conservation-area	Ronald and Maude Hartell Conservation Area
jamesport-community-lake	Jamesport Community Lake
coldwater-conservation-area	Coldwater Conservation Area
sears-community-lake	Sears Community Lake
capps-creek-conservation-area	Capps Creek Conservation Area
trenton-area-trap-skeet-range	Trenton Area Trap and Skeet Range
union-ridge-conservation-area	Union Ridge Conservation Area
wappapello-lake-management-lands	Wappapello Lake Management Lands
smack-out-access	Smack-Out Access
sunrise-lake-cameron	Sunrise Lake (Cameron)
century-lake-cameron	Century Lake (Cameron)
hunter-towersite	Hunter Towersite
mon-shon-prairie-conservation-area	Mon-Shon Prairie Conservation Area
parma-woods-shooting-range-outdoor-education-center	Parma Woods Shooting Range and Outdoor Education Center
indian-hills-conservation-area	Indian Hills Conservation Area
wah-sha-she-prairie	Wah-Sha-She Prairie
eagle-lake-cameron	Eagle Lake (Cameron)
grindstone-lake-cameron	Grindstone Lake (Cameron)
mullanix-ford-access	Mullanix Ford Access
george-vida-martin-access	George and Vida Martin Access
dark-hollow-natural-area	Dark Hollow Natural Area
warm-fork-park-thayer	Warm Fork Park (Thayer)
rose-hill-towersite	Rose Hill Towersite
stones-corner-access	Stones Corner Access
amidon-memorial-conservation-area	Amidon Memorial Conservation Area
ella-ewing-lake-conservation-area	Ella Ewing Lake Conservation Area
pilot-knob-conservation-area	Pilot Knob Conservation Area
diamond-grove-prairie-conservation-area	Diamond Grove Prairie Conservation Area
sharps-station-access	Sharps Station Access
john-baumgardt-memorial-ca	John Baumgardt Memorial CA
neeper-conservation-area	Neeper Conservation Area
wappapello-lake-greenville-recreation-area-us-army-corps-engineers	Wappapello Lake, Greenville Recreation Area (U.S. Army Corps of Engineers)
anthony-beatrice-kendzora-conservation-area	Anthony and Beatrice Kendzora Conservation Area
cherry-corner-access	Cherry Corner Access
schimmel-city-access	Schimmel City Access
union-mill-access	Union Mill Access
pony-express-lake-conservation-area	Pony Express Lake Conservation Area
st-mary-access	St. Mary Access
platte-falls-conservation-area	Platte Falls Conservation Area
carl-junction-access	Carl Junction Access
little-whitewater-conservation-area	Little Whitewater Conservation Area
morris-prairie-ca	Morris Prairie CA
humphrey-access	Humphrey Access
dr-frederick-marshall-conservation-area	Dr. Frederick Marshall Conservation Area
neosho-towersite	Neosho Towersite
allen-bridge-access	Allen Bridge Access
bradley-hammer-memorial-conservation-area	Bradley A. Hammer Memorial Conservation Area
roaring-river-fish-hatchery	Roaring River Fish Hatchery
mineral-hills-conservation-area	Mineral Hills Conservation Area
roaring-river-conservation-area	Roaring River Conservation Area
tipton-ford-access	Tipton Ford Access
little-black-conservation-area	Little Black Conservation Area
marquand-access	Marquand Access
guy-b-park-conservation-area	Guy B. Park Conservation Area
green-access	Green Access
lake-showme-memphis	Lake Showme (Memphis)
shoal-creek-conservation-education-center	Shoal Creek Conservation Education Center
wildcat-access	Wildcat Access
lime-kiln-access	Lime Kiln Access
wildcat-glade-natural-area	Wildcat Glade Natural Area
rose-pond-conservation-area	Rose Pond Conservation Area
willow-brook-lake-maysville	Willow Brook Lake (Maysville)
hawn-access	Hawn Access
morse-park-neosho	Morse Park (Neosho)
perry-county-community-lake	Perry County Community Lake
blue-spring-branch-conservation-area	Blue Spring Branch Conservation Area
walter-woods-conservation-area	Walter Woods Conservation Area
burton-bridge-access	Burton Bridge Access
archangel-access	Archangel Access
iron-bridge-access	Iron Bridge Access
myrtle-access	Myrtle Access
fort-crowder-conservation-area	Fort Crowder Conservation Area
mcclure-conservation-area	McClure Conservation Area
greenville-ford-access	Greenville Ford Access
perryville-district-headquarters	Perryville District Headquarters
bicentennial-conservation-area	Bicentennial Conservation Area
belcher-branch-lake-conservation-area	Belcher Branch Lake Conservation Area
wayne-helton-memorial-wildlife-area	The Wayne Helton Memorial Wildlife Area
castor-river-conservation-area	Castor River Conservation Area
neosho-district-headquarters	Neosho District Headquarters
savage-access	Savage Access
legion-lake-1-perry-county	Legion Lake 1 (Perry County)
bee-creek-conservation-area	Bee Creek Conservation Area
flag-spring-conservation-area	Flag Spring Conservation Area
agency-conservation-area	Agency Conservation Area
agency-access	Agency Access
hendrickson-access-mark-twain-national-forest	Hendrickson Access (Mark Twain National Forest)
lancaster-city-lake	Lancaster City Lake
lake-mahoney-unionville	Lake Mahoney (Unionville)
russell-b-hazel-s-arnold-l-vandyke-conservation-area	Russell B., Hazel S. and Arnold L. VanDyke Conservation Area
doniphan-towersite	Doniphan Towersite
fourche-creek-conservation-area	Fourche Creek Conservation Area
mudpuppy-conservation-area	Mudpuppy Conservation Area
wappapello-lake-choania-landing-recreation-area-us-army-corps-engineers	Wappapello Lake, Choania Landing Recreation Area (U.S. Army Corps of Engineers)
fox-valley-lake-conservation-area	Fox Valley Lake Conservation Area
t-l-wright-memorial-access-doniphan	T. L. Wright Memorial Access (Doniphan)
rebels-cove-conservation-area	Rebel&#039;s Cove Conservation Area
grassy-towersite	Grassy Towersite
saxton-access	Saxton Access
frost-island-conservation-area	Frost Island Conservation Area
gipsy-towersite	Gipsy Towersite
fort-pike-access	Fort Pike Access
yokum-school-conservation-area	Yokum School Conservation Area
university-forest-conservation-area	University Forest Conservation Area
sweetgum-access	Sweetgum Access
pigeon-hill-conservation-area	Pigeon Hill Conservation Area
goodman-towersite	Goodman Towersite
elam-bend-conservation-area	Elam Bend Conservation Area
lake-paho-conservation-area	Lake Paho Conservation Area
paul-bloch-memorial-pond-lancaster	Paul Bloch Memorial Pond (Lancaster)
william-e-crawford-conservation-area	William E. Crawford Conservation Area
marble-hill-pellegrino-lake	Marble Hill (Pellegrino Lake)
clark-conservation-area	Clark Conservation Area
king-lake-conservation-area	King Lake Conservation Area
chloe-lowry-marsh-natural-area	Chloe Lowry Marsh Natural Area
hilliard-access	Hilliard Access
charlie-heath-memorial-conservation-area	Charlie Heath Memorial Conservation Area
andy-denton-access	Andy Denton Access
wappapello-lake-spillway-recreation-area-stairways-us-army-corps-engineers	Wappapello Lake, Spillway Recreation Area stairways (U.S. Army Corps of Engineers)
old-plantation-access	Old Plantation Access
maple-flats-access	Maple Flats Access
old-bethany-city-lake-bethany	Old Bethany City Lake (Bethany)
northwest-regional-office	Northwest Regional Office
everyday-pond-missouri-western-state-university	Everyday Pond (Missouri Western State University)
powell-towersite	Powell Towersite
little-bean-marsh-conservation-area	Little Bean Marsh Conservation Area
stephen-j-sun-conservation-area	Stephen J. Sun Conservation Area
ringo-ford-access	Ringo Ford Access
north-bethany-city-reservoir-bethany	North Bethany City Reservoir (Bethany)
mark-youngdahl-urban-conservation-area	Mark Youngdahl Urban Conservation Area
bluffwoods-conservation-area	Bluffwoods Conservation Area
maintz-wildlife-preserve	Maintz Wildlife Preserve
red-rock-landing-conservation-area	Red Rock Landing Conservation Area
bluffwoods-conservation-area-goodell-memorial-annex	Bluffwoods Conservation Area - Goodell Memorial Annex
poplar-bluff-conservation-area	Poplar Bluff Conservation Area
sank-conservation-area	Sank Conservation Area
deep-ford-access	Deep Ford Access
dark-cypress-swamp-unit-duck-creek-conservation-area	Dark Cypress Swamp Unit of Duck Creek Conservation Area
rochester-falls-access	Rochester Falls Access
huckleberry-ridge-conservation-area	Huckleberry Ridge Conservation Area
sportsmans-park-access-poplar-bluff	Sportsman&#039;s Park Access (Poplar Bluff)
st-joseph-corby-pond	St. Joseph (Corby Pond)
james-clark-access	James Clark Access
duck-creek-conservation-area	Duck Creek Conservation Area
greenbrier-unit-duck-creek-conservation-area	Greenbrier Unit of Duck Creek Conservation Area
buffalo-hills-natural-area	Buffalo Hills Natural Area
dabbs-greer-town-hole-park-access-anderson	Dabbs Greer Town Hole Park and Access (Anderson)
harviell-access	Harviell Access
hemenway-conservation-area	Hemenway Conservation Area
jentell-brees-access	Jentell Brees Access
krug-park-lagoon-st-joseph	Krug Park Lagoon (St Joseph)
limpp-community-lake	Limpp Community Lake
wilfrid-v-anna-c-kneib-memorial-conservation-area	Wilfrid V. and Anna C. Kneib Memorial Conservation Area
city-pineville-elk-river-access	City of Pineville Elk River Access
french-bottom-access-st-joseph	French Bottom Access (St. Joseph)
grand-trace-conservation-area	Grand Trace Conservation Area
lake-girardeau-conservation-area	Lake Girardeau Conservation Area
arthur-dupree-memorial-conservation-area	Arthur DuPree Memorial Conservation Area
seventy-six-conservation-area	Seventy-Six Conservation Area
rock-quarry-access	Rock Quarry Access
caroline-sheridan-logan-memorial-wildlife-area	Caroline Sheridan Logan Memorial Wildlife Area
sunbridge-hills-conservation-area	Sunbridge Hills Conservation Area
lanagan-access	Lanagan Access
lanagan-towersite	Lanagan Towersite
elrod-mill-access	Elrod Mill Access
harrison-county-lake	Harrison County Lake
dan-river-access	Dan River Access
corkwood-conservation-area	Corkwood Conservation Area
block-hole-access	Block Hole Access
sand-pond-conservation-area	Sand Pond Conservation Area
mount-shira-access	Mount Shira Access
peter-john-bagley-woods-conservation-area	Peter and John Bagley Woods Conservation Area
fisk-access	Fisk Access
savannah-duncan-park-north-pond	Savannah (Duncan Park North Pond)
savannah-duncan-park-south-pond	Savannah (Duncan Park South Pond)
cowskin-access	Cowskin Access
happy-holler-lake-conservation-area	Happy Holler Lake Conservation Area
worthwine-island-conservation-area	Worthwine Island Conservation Area
rotary-lake-jackson	Rotary Lake (Jackson)
crowleys-ridge-conservation-area	Crowleys Ridge Conservation Area
savannah-city-lake	Savannah City Lake
apple-creek-conservation-area	Apple Creek Conservation Area
litz-park-lake-jackson	Litz Park Lake (Jackson)
hadorn-bridge-access	Hadorn Bridge Access
big-cane-conservation-area	Big Cane Conservation Area
emmett-leah-seat-memorial-conservation-area	Emmett and Leah Seat Memorial Conservation Area
tower-rock-natural-area	Tower Rock Natural Area
oak-ridge-conservation-area	Oak Ridge Conservation Area
aquilla-access	Aquilla Access
nodaway-island-access	Nodaway Island Access
allred-lake-natural-area	Allred Lake Natural Area
james-d-christie-conservation-area	James D. Christie Conservation Area
sowards-ford-access	Sowards Ford Access
tom-brown-access	Tom Brown Access
eva-n-davis-memorial-conservation-area	The Eva N. Davis Memorial Conservation Area
coon-island-conservation-area	Coon Island Conservation Area
honey-creek-conservation-area	Honey Creek Conservation Area
cape-girardeau-conservation-nature-center	Cape Girardeau Conservation Nature Center
north-park-lake-cape-girardeau-county	North Park Lake (Cape Girardeau County)
southeast-regional-office	Southeast Regional Office
south-park-lake-cape-girardeau-county	South Park Lake (Cape Girardeau County)
otter-slough-conservation-area	Otter Slough Conservation Area
pawnee-prairie-natural-area	Pawnee Prairie Natural Area
monkey-mountain-conservation-area	Monkey Mountain Conservation Area
bristle-ridge-access	Bristle Ridge Access
cape-woods-conservation-area	Cape Woods Conservation Area
midway-access	Midway Access
holly-ridge-conservation-area	Holly Ridge Conservation Area
dexter-city-lake	Dexter City Lake
tywappity-community-lake	Tywappity Community Lake
tywappity-towersite	Tywappity Towersite
cape-girardeau-city-capaha-park-lake	Cape Girardeau City (Capaha Park Lake)
headwaters-access	Headwaters Access
red-star-access	Red Star Access
windy-bar-island-conservation-area	Windy Bar Island Conservation Area
worth-county-community-lake	Worth County Community Lake
riverbreaks-conservation-area	Riverbreaks Conservation Area
payne-landing-access	Payne Landing Access
wilhelmina-conservation-area	Wilhelmina Conservation Area
cape-lacroix-bluffs-conservation-area	Cape LaCroix Bluffs Conservation Area
general-watkins-conservation-area	General Watkins Conservation Area
bridgewater-access	Bridgewater Access
wolf-creek-bend-conservation-area	Wolf Creek Bend Conservation Area
chalk-bluff-trail-access	Chalk Bluff Trail Access
nodaway-valley-conservation-area	Nodaway Valley Conservation Area
keever-bridge-access	Keever Bridge Access
mozingo-lake-maryville	Mozingo Lake (Maryville)
sand-prairie-conservation-area	Sand Prairie Conservation Area
bob-brown-conservation-area	Bob Brown Conservation Area
sheridan-access	Sheridan Access
maitland-access	Maitland Access
jamerson-c-mccormack-conservation-area	Jamerson C. McCormack Conservation Area
sikeston-sikeston-recreation-complex-lake	Sikeston (Sikeston Recreation Complex Lake)
nodaway-county-community-lake	Nodaway County Community Lake
frisbee-cutoff-access	Frisbee Cutoff Access
rush-bottoms-conservation-area	Rush Bottoms Conservation Area
ben-cash-memorial-conservation-area	Ben Cash Memorial Conservation Area
robert-g-delaney-lake-conservation-area	Robert G. Delaney Lake Conservation Area
bilby-ranch-lake-conservation-area	Bilby Ranch Lake Conservation Area
swift-ditch-access	Swift Ditch Access
little-tarkio-prairie	Little Tarkio Prairie
little-river-conservation-area	Little River Conservation Area
k-s-simpkins-park-pond-east-prairie	K. S. Simpkins Park Pond (East Prairie)
new-madrid-forestry-office	New Madrid Forestry Office
new-madrid-bend-access	New Madrid Bend Access
h-f-thurnau-conservation-area	H. F. Thurnau Conservation Area
possum-walk-access	Possum Walk Access
donaldson-point-conservation-area	Donaldson Point Conservation Area
ten-mile-pond-conservation-area	Ten Mile Pond Conservation Area
hornersville-swamp-conservation-area	Hornersville Swamp Conservation Area
corning-conservation-area	Corning Conservation Area
hornersville-access	Hornersville Access
birds-blue-hole	Bird&#039;s Blue Hole
tarkio-prairie-conservation-area	Tarkio Prairie Conservation Area
jos-hunter-moore-access	Jos Hunter Moore Access
twin-borrow-pits-conservation-area	Twin Borrow Pits Conservation Area
wolf-bayou-unit-black-island-conservation-area	Wolf Bayou Unit of Black Island Conservation Area
deroin-bend-conservation-area	Deroin Bend Conservation Area
warbler-woods-conservation-area	Warbler Woods Conservation Area
stephen-c-bradford-unit-black-island-conservation-area	Stephen C. Bradford Unit of Black Island Conservation Area
thirtyfour-corner-blue-hole	Thirtyfour Corner Blue Hole
gayoso-bend-unit-black-island-conservation-area	Gayoso Bend Unit of Black Island Conservation Area
triangle-boat-club-access-pemiscot-county	Triangle Boat Club Access (Pemiscot County)
john-l-georgia-girvin-conservation-area	John L. and Georgia Girvin Conservation Area
seven-island-conservation-area	Seven Island Conservation Area
seven-island-access	Seven Island Access
hoot-owl-bend-access	Hoot Owl Bend Access
desoto-unit-black-island-conservation-area	DeSoto Unit of Black Island Conservation Area
aspinwall-bend	Aspinwall Bend
langdon-bend-access	Langdon Bend Access
s-p-reynolds-access	S. P. Reynolds Access
dorena-access	Dorena Access
brickyard-hill-conservation-area	Brickyard Hill Conservation Area
nishnabotna-conservation-area	Nishnabotna Conservation Area
watson-access	Watson Access
star-school-hill-prairie-conservation-area	Star School Hill Prairie Conservation Area
lower-hamburg-bend-conservation-area	Lower Hamburg Bend Conservation Area
